3 3 3 3 3 3 3 3 3 3 3 3 3 3 3 3 3 3 3 3 3 3 3 3 3 3 3 3 3 3  
3 5 3 0 0 3 0 0 0 0 0 0 3 0 3 0 3 0 0 0 0 0 0 0 0 0 0 0 0 3 
3 0 3 0 0 3 3 0 3 3 3 0 3 0 0 0 0 0 3 3 3 3 3 3 3 3 3 3 0 3 
3 0 0 3 0 0 0 0 0 0 3 0 0 0 3 3 3 3 3 0 0 0 0 0 0 0 0 3 0 3 
3 0 0 3 0 0 0 3 3 3 3 3 3 0 3 0 3 0 0 0 0 3 3 3 3 3 0 3 0 3  
3 0 3 3 0 0 3 0 0 0 0 3 3 3 3 0 0 0 3 0 3 0 0 0 0 3 0 3 0 3 
3 0 0 3 0 0 3 0 0 0 0 0 3 0 3 3 3 3 3 0 3 0 0 3 0 0 0 3 0 3 
3 0 3 3 0 0 3 0 3 0 3 3 3 0 0 0 0 0 0 0 3 0 0 3 0 3 3 3 0 3 
3 0 3 0 0 0 3 0 3 0 0 3 3 0 3 3 3 3 3 3 3 3 3 3 0 3 0 3 0 3 
3 0 3 0 3 3 3 0 3 0 0 0 0 0 0 0 0 0 0 0 0 0 0 0 0 0 0 3 0 3 
3 0 3 7 3 0 0 0 3 3 3 3 3 3 0 3 3 3 3 0 3 3 3 3 3 3 0 3 0 3 
3 0 3 0 3 3 3 0 3 3 0 0 3 0 0 0 0 0 3 0 0 0 0 0 0 0 0 3 0 3 
3 0 3 0 3 0 0 0 0 3 0 0 3 3 3 3 3 0 3 0 3 3 3 3 3 3 3 3 0 3 
3 0 3 0 3 3 3 3 0 3 0 0 0 4 4 4 3 0 3 0 3 0 0 3 0 0 0 3 0 3 
3 0 3 0 3 0 3 0 0 3 0 0 3 4 4 4 3 0 3 0 3 0 0 3 0 0 0 3 0 3 
3 0 3 0 3 3 3 0 3 3 3 0 3 4 4 4 3 0 3 3 3 0 0 0 0 0 0 3 0 3  
3 0 3 0 0 0 3 0 0 0 3 0 3 3 3 3 3 0 0 0 0 0 0 0 0 0 0 0 0 3 
3 0 3 0 3 3 3 3 3 0 3 0 3 0 0 0 3 3 0 3 3 3 0 3 3 3 3 3 0 3 
3 0 3 0 0 0 0 0 3 0 3 0 0 3 0 0 0 0 0 0 0 0 0 0 0 0 0 0 0 3 
3 0 3 0 0 3 3 3 3 0 3 3 3 3 3 3 3 3 3 3 3 3 8 3 3 3 3 3 3 3 
3 0 3 0 0 0 0 3 0 0 0 0 0 0 0 0 0 0 3 0 0 0 0 0 0 0 0 3 0 3 
3 0 3 0 3 3 0 3 0 3 3 3 3 3 3 3 3 0 3 3 3 3 3 3 3 3 0 3 0 3 
3 0 3 0 0 3 0 3 0 0 0 0 0 3 0 0 0 0 0 0 0 0 0 0 0 0 0 3 9 3 
3 0 3 0 3 3 0 3 3 3 3 3 3 3 3 3 3 0 3 3 3 3 3 3 3 0 0 3 0 3 
3 0 3 0 0 0 0 0 0 0 0 0 0 0 0 0 3 0 3 0 0 0 0 0 3 0 0 3 3 3 
3 0 3 3 3 3 3 3 3 3 3 0 0 3 3 0 3 0 3 3 3 3 3 0 3 0 0 3 0 3 
3 0 3 0 0 0 0 0 0 0 3 0 3 3 0 0 0 0 0 0 0 0 3 0 3 0 0 3 0 3 
3 0 3 3 0 3 3 3 0 3 3 0 3 3 3 3 0 3 3 3 3 0 3 3 3 0 3 3 0 3 
3 0 0 0 0 0 0 3 0 0 0 0 0 3 0 0 0 0 0 0 0 0 0 0 0 0 0 0 6 3 
3 3 3 3 3 3 3 3 3 3 3 3 3 3 3 3 3 3 3 3 3 3 3 3 3 3 3 3 3 3 