2 2 2 2 2 2 2 2 2 2 2 2 2 2 2 2 2 2 2 2 2 2 2 2 2 2 2 2 2 2 
2 5 0 0 0 2 0 0 0 0 0 0 2 0 2 0 2 0 0 0 0 0 0 0 0 0 0 0 0 2 
2 0 2 0 0 2 2 0 2 2 2 0 2 0 0 0 0 0 2 2 2 2 2 2 2 2 2 2 0 2 
2 0 0 2 2 0 0 0 0 0 2 2 0 0 2 0 2 2 2 0 0 0 0 0 8 0 0 2 0 2 
2 0 0 2 0 0 0 2 2 2 2 2 2 0 2 0 2 0 2 0 0 2 2 2 2 2 0 2 0 2  
2 0 2 2 0 0 2 0 0 0 0 2 2 2 2 0 0 0 2 0 2 2 0 0 0 2 0 2 0 2 
2 0 0 2 0 0 2 0 2 0 0 0 2 0 2 2 2 2 2 0 2 0 0 2 0 0 0 2 0 2 
2 0 2 2 0 0 2 0 2 0 2 2 2 2 0 0 0 0 0 0 2 0 0 2 0 2 2 2 0 2 
2 0 2 0 0 0 2 0 2 0 0 0 2 0 2 2 2 2 2 2 2 2 2 2 0 2 0 2 0 2 
2 0 2 0 2 2 2 0 2 0 0 0 0 0 2 0 0 0 0 0 0 0 0 0 0 2 0 2 0 2 
2 0 2 0 2 0 0 0 2 2 2 2 2 2 2 2 2 2 2 0 2 2 2 2 2 2 0 2 9 2 
2 0 2 0 2 2 2 0 2 2 0 0 2 0 0 0 0 0 2 0 0 0 0 0 0 0 0 2 0 2 
2 0 2 0 2 0 0 0 0 2 0 0 2 2 2 2 2 0 2 0 2 2 2 0 2 2 2 2 0 2 
2 0 0 0 2 2 0 2 0 2 0 0 2 4 4 4 2 0 2 0 2 0 0 2 0 0 0 0 0 2 
2 0 2 0 2 0 2 0 0 2 0 0 2 4 4 4 2 0 0 0 2 0 0 2 0 0 0 2 2 2 
2 0 2 0 2 2 2 0 2 2 0 0 2 4 4 4 2 2 0 2 2 0 0 0 8 0 0 0 0 2  
2 0 2 0 0 0 2 0 0 0 2 0 2 2 2 2 2 0 0 0 0 0 0 0 0 0 0 2 0 2 
2 0 2 0 2 2 2 2 2 0 2 0 2 0 0 0 2 2 2 2 2 2 0 2 2 2 2 2 0 2 
2 0 0 0 0 0 0 0 2 0 2 0 0 2 0 0 2 0 0 0 0 0 0 0 0 0 0 0 0 2 
2 0 0 0 2 2 2 2 2 0 2 2 2 2 0 2 2 2 2 2 2 2 2 2 2 2 2 2 0 2 
2 0 2 0 0 2 0 2 0 0 0 0 0 0 0 0 0 0 2 0 0 0 0 0 0 0 0 2 0 2 
2 0 2 0 2 2 0 2 0 2 2 2 0 2 0 2 2 2 2 2 2 2 2 2 2 2 0 2 0 2 
2 0 2 0 0 2 0 2 0 0 0 0 0 2 0 0 2 0 2 0 0 0 0 0 0 0 0 2 0 2 
2 0 2 0 2 2 0 2 2 2 2 0 2 2 0 2 2 0 2 2 2 2 2 2 2 0 0 2 0 2 
2 0 2 0 0 0 0 0 0 0 0 0 0 0 0 0 2 0 2 0 0 0 0 0 2 0 0 2 2 2 
2 0 2 2 2 2 2 2 2 2 2 0 0 2 0 0 2 0 2 2 2 2 2 0 2 0 0 2 0 2 
2 0 2 2 2 0 0 0 0 0 2 0 2 2 0 0 2 0 0 0 0 0 2 0 2 0 0 2 0 2 
2 0 2 2 0 0 2 2 0 2 2 0 2 2 0 2 0 0 2 2 2 0 2 2 2 0 2 2 0 2 
2 0 0 7 0 0 0 2 0 0 0 0 0 2 0 0 0 0 0 0 0 0 0 0 0 0 0 0 6 2 
2 2 2 2 2 2 2 2 2 2 2 2 2 2 2 2 2 2 2 2 2 2 2 2 2 2 2 2 2 2 